Guess – угадывать  
Miss – скучать по кому-то / пропустить  
Spend – тратить (время или деньги)  
Save – сохранять / копить  
Borrow – брать взаймы  
Lend – давать взаймы  
Arrive – прибывать  
Leave – покидать, уходить  
Improve – улучшать  
Forget – забывать  
Remind – напоминать  
Carry – нести  
Drop – ронять  
Hurry – спешить  
Trust – доверять  
Complain – жаловаться  
Invite – приглашать  
Offer – предлагать  
Suggest – предлагать (идею)  
Avoid – избегать  
Decide – решать, принимать решение  
Realize – осознавать  
Notice – замечать  
Guess – догадываться  
Manage – справляться  
Happen – происходить  
Join – присоединяться  
Behave – вести себя  
Lie – лгать  
Argue – спорить  
Shout – кричать  
Whisper – шептать  
Knock – стучать  
Hide – прятать / прятаться  
Break – ломать  
Fix – чинить  
Grow – расти / выращивать  
Collect – собирать (предметы, марки, игрушки)  
Improve – улучшать  
Measure – измерять  
Fit – подходить по размеру  
Earn – зарабатывать  
Deliver – доставлять  
Guess – угадывать  
Bother – беспокоить  
Deserve – заслуживать  
Choose – выбирать  
Agree – соглашаться  
Promise – обещать  
Refuse – отказываться  
