Pretend – притворяться  
Escape – сбежать, избежать  
Rush – мчаться, торопиться  
Delay – задерживать  
Discover – открывать, находить  
Compare – сравнивать  
Describe – описывать  
Prefer – предпочитать  
Trust – доверять  
Guess – догадываться  
Explore – исследовать  
Expect – ожидать  
Depend – зависеть  
Complain – жаловаться  
Argue – спорить  
Arrange – организовывать, договариваться  
Cancel – отменять  
Repair – ремонтировать  
Improve – улучшать  
Protect – защищать  
Move – переезжать / двигаться  
Notice – замечать  
Recognize – узнавать  
Avoid – избегать  
Suggest – предлагать  
Agree – соглашаться  
Disagree – не соглашаться  
Remind – напоминать  
Repeat – повторять  
Invite – приглашать  
Arrive – прибывать  
Believe – верить  
Miss – скучать / опаздывать  
Guess – угадывать  
Include – включать в себя  
Remove – удалять  
Hide – прятать  
Appear – появляться  
Disappear – исчезать  
Complain – жаловаться  
Trust – доверять  
Earn – зарабатывать  
Borrow – брать в долг  
Lend – давать в долг  
Measure – измерять  
Offer – предлагать (вещь или помощь)  
Refuse – отказываться  
Promise – обещать  
Forget – забывать  
Remind – напоминать  
