accountant - бухгалтер  
achievement - достижение  
advertise - рекламировать  
agreement - соглашение, договор  
agriculture - сельское хозяйство  
alarm - тревога, сигнализация  
ambition - амбиция, стремление  
analyze - анализировать  
announcement - объявление  
anxiety - тревога, беспокойство  
architect - архитектор  
article - статья, артикль  
assistant - ассистент, помощник  
atmosphere - атмосфера  
audience - аудитория, зрители  
backpack - рюкзак  
balance - баланс, равновесие  
behavior - поведение  
bilingual - двуязычный  
biography - биография  
brand - бренд, марка  
budget - бюджет  
candidate - кандидат  
carbohydrate - углевод  
carnival - карнавал  
cashier - кассир  
ceremony - церемония  
chemistry - химия  
climate - климат  
colleague - коллега  
communicate - общаться  
comparison - сравнение  
competition - соревнование, конкуренция  
complain - жаловаться  
concentrate - концентрироваться  
confident - уверенный  
confirm - подтверждать  
consequence - последствие  
considerable - значительный  
construction - строительство  
consumer - потребитель  
contribution - вклад  
convenience - удобство  
cooperation - сотрудничество  
corporate - корпоративный  
creativity - креативность, творчество  
critic - критик  
cultural - культурный  
currency - валюта  
deadline - крайний срок, дедлайн  
decade - десятилетие  
decoration - украшение, декор  
democracy - демократия  
destination - пункт назначения  
determination - решительность, целеустремленность  
development - развитие  
difference - разница, отличие  
disability - инвалидность, неспособность  
discount - скидка  
discrimination - дискриминация  
documentary - документальный фильм  
donation - пожертвование  
earthquake - землетрясение  
efficiency - эффективность  
election - выборы  
electronic - электронный  
emergency - чрезвычайная ситуация, экстренный случай  
employment - занятость, трудоустройство  
encourage - поощрять, вдохновлять  
engagement - помолвка, обязательство  
entertainment - развлечение  
entrepreneur - предприниматель  
environment - окружающая среда  
essential - важный, необходимый  
establish - устанавливать, основывать  
estimate - оценивать  
evidence - доказательство  
evolution - эволюция  
examine - исследовать, проверять  
exchange - обмен  
exhibition - выставка  
experiment - эксперимент  
exploration - исследование  
expression - выражение  
facilities - удобства, оборудование  
failure - неудача, провал  
finance - финансы  
flexible - гибкий  
foundation - основание, фундамент  
generation - поколение  
government - правительство  
graduation - выпускной  
guarantee - гарантия  
household - домохозяйство, бытовой  
hurricane - ураган  
identity - личность, идентичность  
immigration - иммиграция  
impression - впечатление  
improvement - улучшение  
independence - независимость  
individual - индивидуальный, личность
industrial - промышленный
influence - влияние
informative - информативный
injury - травма, повреждение
inspiration - вдохновение
instruction - инструкция, руководство
intellectual - интеллектуальный
intention - намерение
interaction - взаимодействие
investment - инвестиция
invisible - невидимый
involvement - участие, вовлеченность
journalism - журналистика
justice - справедливость
landscape - пейзаж
leadership - руководство, лидерство
leisure - досуг, свободное время
license - лицензия
limitation - ограничение
location - местоположение
logical - логичный
luxury - роскошь
management - управление
manufacturer - производитель
marathon - марафон
marketing - маркетинг
maximum - максимум
mechanism - механизм
membership - членство
mentality - менталитет
minimum - минимум
minority - меньшинство
motivation - мотивация
narrative - повествование
negotiation - переговоры
network - сеть
nomination - номинация
obligation - обязательство
observation - наблюдение
obstacle - препятствие
occupation - профессия, занятие
opponent - противник, оппонент
opportunity - возможность
optimistic - оптимистичный
originality - оригинальность
outcome - результат, исход
outdoor - уличный, наружный
output - выход, продукция
overall - общий, в целом
overcome - преодолевать
partnership - партнёрство
patience - терпение
payment - оплата
performance - производительность, выступление
permanent - постоянный
permission - разрешение
personality - личность, характер
perspective - перспектива
phenomenon - явление
pollution - загрязнение
popularity - популярность
portion - порция
possession - владение, имущество
potential - потенциал
precaution - предосторожность
prediction - предсказание
preparation - подготовка
prescription - рецепт (медицинский)
presentation - презентация
preservation - сохранение
priority - приоритет
probability - вероятность
procedure - процедура
processing - обработка
profession - профессия
progress - прогресс
promotion - продвижение
protection - защита
publication - публикация
qualification - квалификация
recognition - признание
recommendation - рекомендация
recovery - восстановление
reduction - сокращение, уменьшение
reflection - отражение
reform - реформа
rejection - отказ
relationship - отношения
reliability - надежность
reputation - репутация
requirement - требование
reservation - бронь, резервирование
residential - жилой
resolution - решение (задачи, конфликта)
resource - ресурс
restriction - ограничение
retirement - выход на пенсию
revolution - революция
risky - рискованный
satisfaction - удовлетворение
schedule - расписание
selection - отбор, выбор
sensation - ощущение
sensitivity - чувствительность
separation - разделение
session - сессия, заседание
significance - значимость
similarity - сходство
situation - ситуация
skilled - опытный, квалифицированный
sociable - общительный
solution - решение
sponsorship - спонсорство
stability - стабильность
statistics - статистика
strategy - стратегия
structure - структура
suitable - подходящий
supervision - надзор, контроль
supply - поставка, снабжение
survival - выживание
suspicion - подозрение
symbolic - символический
technical - технический
technique - техника, метод
technology - технология
tendency - тенденция
tournament - турнир
tradition - традиция
transaction - сделка, транзакция
transformation - трансформация
translation - перевод
transportation - транспортировка
trend - тренд, тенденция
trustworthy - заслуживающий доверия
unemployment - безработица
unexpected - неожиданный
unique - уникальный
universal - универсальный
urban - городской
valuable - ценный
variation - вариация, изменение
visibility - видимость
volunteer - волонтер
vulnerable - уязвимый
widespread - широко распространенный
workshop - мастерская, семинар
worthwhile - стоящий, заслуживающий внимания