Slice – нарезать тонкими кусочками  
Grate – натереть на тёрке  
Stir – помешивать  
Whisk – взбивать венчиком  
Simmer – томить на медленном огне  
Chop – порубить на мелкие куски  
Mash – размять (например, картофель)  
Peel – очистить от кожуры  
Fry – жарить на сковороде  
Roast – запекать в духовке (особенно мясо, овощи)  
Bake – печь (например, пироги, хлеб)  
Boil – довести до кипения  
Steam – готовить на пару  
Sauté – обжаривать слегка и быстро  
Season – приправить специями  
Blend – смешать до однородности  
Pour – наливать  
Spread – намазывать  
Knead – месить тесто  
Crack – разбить (например, яйцо)  
Melt – растопить  
Roll – раскатать  
Layer – выкладывать слоями  
Skim – снимать пену или жир  
Marinate – замариновать  
Serve – подавать блюдо  
Garnish – украсить еду  
Cool – остудить  
Preheat – заранее разогреть (духовку)  
Flip – перевернуть  
Drain – слить воду  
Sift – просеять  
Dip – обмакнуть  
Cube – нарезать кубиками  
Grease – смазать (противень, форму)  
Coat – покрыть (соусом, панировкой)  
Sprinkle – посыпать  
Zest – снять цедру  
Glaze – покрыть глазурью  
Carve – нарезать (готовое мясо, птицу)  
Broil – запекать под верхним огнём (гриль)  
Poach – варить в жидкости на низком огне  
Mix – перемешивать  
Pour in – влить внутрь  
Toss – перемешать (например, салат)  
Combine – соединить ингредиенты  
Chill – охладить (в холодильнике)  
Soak – замочить  
Set – застыть (о желе, десерте)  
Devour – съесть с жадностью  
Taste – пробовать  
