Burglary – незаконное проникновение в здание с целью кражи  
Vandalism – порча имущества (граффити, сломанные вещи)  
Assault – нападение на человека  
Pickpocket – карманник  
Fraud – обман с целью выгоды (например, финансовой)  
Kidnapping – похищение человека  
Mugging – ограбление с применением насилия на улице  
Trespassing – незаконное проникновение на частную территорию  
Shoplifting – кража в магазине  
Cybercrime – преступление в интернете  
Blackmail – вымогательство угрозой  
Forgery – подделка документов или подписей  
Smuggling – контрабанда  
Arson – поджог  
Bribery – взяточничество  
Corruption – системная нечестность (особенно у власти)  
Sentence – наказание, приговор  
Fine – штраф  
Jail – тюрьма (разговорное)  
Inmate – заключённый  
Court – суд  
Trial – судебный процесс  
Judge – судья  
Lawyer – адвокат  
Witness – свидетель  
Evidence – доказательство  
Investigation – расследование  
Fingerprint – отпечаток пальца  
CCTV – камера видеонаблюдения  
Patrol – патруль  
Alarm – сигнал тревоги  
Victim – пострадавший  
Suspect – подозреваемый  
Criminal – преступник  
Offender – нарушитель  
Self-defense – самооборона  
Emergency – чрезвычайная ситуация  
Security – охрана, безопасность  
Neighborhood – район проживания  
Curfew – ограничение выхода из дома в определённое время  
Safe – защищённый  
Risky – опасный, рискованный  
Warning – предупреждение  
Precaution – мера предосторожности  
Helpline – служба экстренной помощи  
Escape – побег  
Rescue – спасение  
Report – сообщить в полицию  
Search – обыск или расследование  
Scene – место происшествия  
Law – закон  
