environment – окружающая среда
ecology – экология
nature – природа
conservation – сохранение
sustainability – устойчивость
renewable – возобновляемый
nonrenewable – невозобновляемый
resource – ресурс
pollution – загрязнение
waste – отходы
recycle – перерабатывать
recycling – переработка
climate change – изменение климата
global warming – глобальное потепление
carbon footprint – углеродный след
greenhouse gas – парниковый газ
deforestation – вырубка лесов
reforestation – лесовосстановление
biodiversity – биоразнообразие
ecosystem – экосистема
habitat – местообитание
species – вид
endangered – находящийся под угрозой
extinction – вымирание
organic – органический
pesticide – пестицид
fertilizer – удобрение
sustainable – устойчивый
conservationist – защитник природы
natural resource – природный ресурс
water scarcity – нехватка воды
renewable energy – возобновляемая энергия
solar power – солнечная энергия
wind power – энергия ветра
hydroelectric – гидроэнергетический
geothermal – геотермальный
biomass – биомасса
fossil fuel – ископаемое топливо
oil – нефть
gas – газ
coal – уголь
emission – выброс
smog – смог
ozone layer – озоновый слой
acid rain – кислотный дождь
waste management – управление отходами
landfill – свалка
compost – компост
biodegradable – биоразлагаемый
ecosystem balance – экологический баланс
conservation area – охраняемая территория
national park – национальный парк
nature reserve – природный заповедник
wildlife – дикая природа
flora – растительность
fauna – животный мир
urbanization – урбанизация
desertification – опустынивание
reclamation – рекультивация
environmental impact – воздействие на природу
sustainability report – отчет по устойчивому развитию
eco-friendly – экологичный
green technology – зеленые технологии
climate – климат
weather – погода
natural disaster – стихийное бедствие
flood – наводнение
earthquake – землетрясение
hurricane – ураган
tsunami – цунами
wildfire – лесной пожар
conservation effort – усилие по сохранению
environmental protection – охрана природы
renewable resource – возобновляемый ресурс
energy efficiency – энергоэффективность
sustainable development – устойчивое развитие
ecological footprint – экологический след
carbon emission – выброс углерода
climate policy – климатическая политика
environmental law – экологическое законодательство
recycling center – пункт переработки
green energy – зеленая энергия
pollution control – контроль загрязнений
water treatment – очистка воды
air quality – качество воздуха
soil erosion – эрозия почвы
habitat destruction – разрушение местообитаний
conservation project – проект по сохранению
renewable technology – возобновляемая технология
environmental awareness – экологическая осведомленность
