leisure – досуг
free time – свободное время
hobby – хобби
interest – интерес
pastime – занятие
relaxation – расслабление
vacation – отпуск
holiday – каникулы
travel – путешествие
picnic – пикник
camping – кемпинг
hiking – поход
cycling – велоспорт
jogging – пробежка
swimming – плавание
dancing – танцы
singing – пение
drawing – рисование
painting – живопись
photography – фотография
reading – чтение
writing – письмо
music – музыка
playing guitar – игра на гитаре
playing piano – игра на пианино
watching movies – просмотр фильмов
cinema – кинотеатр
theater – театр
concert – концерт
museum – музей
exhibition – выставка
festival – фестиваль
game – игра
video game – видеоигра
board game – настольная игра
card game – карточная игра
puzzle – головоломка
chess – шахматы
football – футбол
basketball – баскетбол
tennis – теннис
golf – гольф
yoga – йога
meditation – медитация
spa – спа
massage – массаж
sauna – сауна
reading book – чтение книги
relaxing – отдых
sunbathing – загорание
stargazing – наблюдение за звёздами
birdwatching – наблюдение за птицами
shopping – шоппинг
dining out – обед вне дома
karaoke – караоке
party – вечеринка
celebration – празднование
socializing – общение
chatting – болтовня
blogging – ведение блога
surfing the internet – серфинг в интернете
playing sports – занятия спортом
cycling trip – велопоездка
fishing – рыбалка
gardening – садоводство
cooking class – кулинарный мастер-класс
art class – урок искусства
pottery – гончарное дело
reading magazine – чтение журнала
radio – радио
podcast – подкаст
streaming – потоковое видео
DIY – своими руками
crafting – рукоделие
volunteering – волонтёрство
charity – благотворительность
relaxation time – время отдыха
unwind – расслабляться
break – перерыв
leisure activity – развлечение