Hello – привет  
Goodbye – пока  
Please – пожалуйста  
Thank you – спасибо  
Yes – да  
No – нет  
Name – имя  
Friend – друг  
Family – семья  
Mother – мама  
Father – папа  
Brother – брат  
Sister – сестра  
House – дом  
Room – комната  
School – школа  
Teacher – учитель  
Student – ученик  
Book – книга  
Pen – ручка  
Chair – стул  
Table – стол  
Window – окно  
Door – дверь  
Bag – сумка  
Food – еда  
Water – вода  
Milk – молоко  
Bread – хлеб  
Apple – яблоко  
Dog – собака  
Cat – кошка  
Day – день  
Night – ночь  
Morning – утро  
Evening – вечер  
Sun – солнце  
Rain – дождь  
Cold – холод  
Hot – жарко  
Happy – счастливый  
Sad – грустный  
Big – большой  
Small – маленький  
Good – хороший  
Bad – плохой  
Go – идти  
Come – приходить  
Eat – есть  
Drink – пить  
Sleep – спать  
