Monday - понедельник
Tuesday - вторник
Wednesday - среда
Thursday - четверг
Friday - пятница
Saturday - суббота
Sunday - воскресенье
January - январь
February - февраль
March - март
April - апрель
May - май
June - июнь
July - июль
August - август
September - сентябрь
October - октябрь
November - ноябрь
December - декабрь
spring - весна
summer - лето
autumn - осень
winter - зима
day - день
night - ночь
morning - утро
afternoon - после полудня
evening - вечер
week - неделя
month - месяц
year - год
today - сегодня
tomorrow - завтра
yesterday - вчера
weekend - выходные
weekday - будний день
holiday - праздник
season - сезон
calendar - календарь
decade - десятилетие
century - век
hour - час
minute - минута
second - секунда
dawn - рассвет
dusk - сумерки
midnight - полночь
sunrise - восход
sunset - закат
solstice - солнцестояние
equinox - равноденствие
annual - ежегодный
monthly - ежемесячный
weekly - еженедельный
daily - ежедневный
era - эпоха
period - период
duration - продолжительность
future - будущее
past - прошлое
present - настоящее
moment - момент
time - время
timeline - временная линия
instant - мгновение
noon - полдень
seasonality - сезонность
timeframe - временной промежуток
chronology - хронология
schedule - расписание