bread - хлеб
butter - масло
cheese - сыр
egg - яйцо
milk - молоко
water - вода
apple - яблоко
banana - банан
orange - апельсин
grape - виноград
lemon - лимон
peach - персик
pear - груша
strawberry - клубника
blueberry - черника
pineapple - ананас
tomato - помидор
potato - картофель
carrot - морковь
lettuce - салат (листья)
cucumber - огурец
pepper - перец
onion - лук
garlic - чеснок
mushroom - гриб
rice - рис
pasta - макароны
soup - суп
salad - салат
burger - бургер
sandwich - сэндвич
pizza - пицца
hot dog - хот-дог
fries - картофель фри
chicken - курица
beef - говядина
pork - свинина
fish - рыба
shrimp - креветка
lobster - омар
sausage - сосиска
bacon - бекон
ham - ветчина
cake - торт
cookie - печенье
pie - пирог
ice cream - мороженое
chocolate - шоколад
candy - конфета
sugar - сахар
salt - соль
oil - растительное масло
vinegar - уксус
sauce - соус
mustard - горчица
ketchup - кетчуп
yogurt - йогурт
cereal - хлопья
oatmeal - овсянка
pancake - блин
waffle - вафля
syrup - сироп
coffee - кофе
tea - чай
juice - сок
soda - газировка
smoothie - смузи
snack - закуска
dessert - десерт
stew - рагу