one - один
two - два
three - три
four - четыре
five - пять
six - шесть
seven - семь
eight - восемь
nine - девять
ten - десять
eleven - одиннадцать
twelve - двенадцать
thirteen - тринадцать
fourteen - четырнадцать
fifteen - пятнадцать
sixteen - шестнадцать
seventeen - семнадцать
eighteen - восемнадцать
nineteen - девятнадцать
twenty - двадцать
twenty-one - двадцать один
twenty-two - двадцать два
twenty-three - двадцать три
twenty-four - двадцать четыре
twenty-five - двадцать пять
twenty-six - двадцать шесть
twenty-seven - двадцать семь
twenty-eight - двадцать восемь
twenty-nine - двадцать девять
thirty - тридцать
red - красный
blue - синий
yellow - жёлтый
green - зелёный
orange - оранжевый
purple - фиолетовый
pink - розовый
brown - коричневый
black - чёрный
white - белый
gray - серый
gold - золотой
silver - серебряный
beige - бежевый
turquoise - бирюзовый
violet - лиловый
indigo - индиго
magenta - маджента
cyan - циан
maroon - бордовый
circle - круг
square - квадрат
triangle - треугольник
rectangle - прямоугольник
oval - овал
diamond - ромб
star - звезда
heart - сердце
pentagon - пятиугольник
hexagon - шестиугольник
octagon - восьмиугольник
cube - куб
sphere - шар
cylinder - цилиндр
cone - конус
pyramid - пирамида
ellipse - эллипс
trapezoid - трапеция
parallelogram - параллелограмм
crescent - полумесяц