school - школа
classroom - класс
teacher - учитель
student - ученик
lesson - урок
homework - домашнее задание
notebook - тетрадь
pencil - карандаш
pen - ручка
eraser - ластик
ruler - линейка
backpack - рюкзак
schoolbag - школьная сумка
desk - парта
chair - стул
blackboard - доска
whiteboard - белая доска
marker - маркер
chalk - мел
book - книга
textbook - учебник
dictionary - словарь
computer - компьютер
laptop - ноутбук
projector - проектор
globe - глобус
map - карта
crayon - цветной карандаш
scissors - ножницы
glue - клей
paper - бумага
notebook paper - лист бумаги
folder - папка
binder - скоросшиватель
pencil case - пенал
calculator - калькулятор
test - тест
exam - экзамен
grade - оценка
subject - предмет
science - наука
math - математика
history - история
geography - география
literature - литература
music - музыка
art class - урок искусства
computer class - урок информатики
library - библиотека
study - учеба
lesson plan - план урока
schedule - расписание
break - перемена
lunch - обед
cafeteria - столовая
project - проект
research - исследование
report - доклад
attendance - посещаемость
field trip - экскурсия
sketchbook - блокнот для эскизов
stapler - степлер
paperclip - скрепка
rubber band - резинка
binder clip - зажим
graduation - выпускной
uniform - форма
diploma - диплом
principal - директор
attendance sheet - ведомость