pathology – патология
etiology – этиология
epidemiology – эпидемиология
diagnosis – диагностика
prognosis – прогноз
comorbidity – коморбидность
morbidity – заболеваемость
mortality – смертность
pharmacology – фармакология
therapeutics – терапевтика
contraindication – противопоказание
adverse effect – побочный эффект
placebo – плацебо
dosage – дозировка
administration – введение
intravenous – внутривенный
intramuscular – внутримышечный
subcutaneous – подкожный
biopharmaceutical – биофармацевтический
clinical trial – клиническое испытание
randomized controlled trial – рандомизированное контролируемое исследование
double-blind – двойное слепое исследование
meta-analysis – мета-анализ
systematic review – систематический обзор
immunotherapy – иммунотерапия
chemotherapy – химиотерапия
radiotherapy – лучевая терапия
surgical intervention – хирургическое вмешательство
minimally invasive – минимально инвазивный
laparoscopy – лапароскопия
endoscopy – эндоскопия
biopsy – биопсия
histology – гистология
pathology report – патологоанатомический отчет
genetic screening – генетическое скринирование
personalized medicine – персонализированная медицина
biomarker – биомаркер
targeted therapy – таргетная терапия
stem cell therapy – терапия стволовыми клетками
regenerative medicine – регенеративная медицина
chronic disease – хроническое заболевание
acute condition – острое состояние
infectious disease – инфекционное заболевание
viral infection – вирусная инфекция
bacterial infection – бактериальная инфекция
antibiotic resistance – устойчивость к антибиотикам
vaccination – вакцинация
immunization – иммунизация
autoimmunity – аутоиммунитет
inflammatory response – воспалительная реакция
metabolic disorder – метаболическое расстройство
endocrine disorder – эндокринное расстройство
cardiovascular – сердечно-сосудистый
neurological – неврологический
psychiatric – психиатрический
dermatological – дерматологический
gastrointestinal – желудочно-кишечный
respiratory – респираторный
musculoskeletal – опорно-двигательный
oncology – онкология
hematology – гематология
cardiology – кардиология
neurology – неврология
endocrinology – эндокринология
gastroenterology – гастроэнтерология
nephrology – нефрология
pulmonology – пульмонология
immunology – иммунология
virology – вирусология
infectious agent – инфекционный агент
pathogen – патоген
antibiotic – антибиотик
antiviral – противовирусный
vaccine efficacy – эффективность вакцины
adverse reaction – неблагоприятная реакция
clinical manifestation – клиническая картина
disease progression – прогрессирование заболевания
remission – ремиссия
relapse – рецидив
palliative care – паллиативная помощь
chronic pain – хроническая боль
rehabilitation – реабилитация
recovery – восстановление
preventive medicine – профилактическая медицина
health maintenance – поддержание здоровья
public health – общественное здоровье
epidemiological study – эпидемиологическое исследование
risk factor – фактор риска
incidence – заболеваемость
prevalence – распространенность
morbidity rate – уровень заболеваемости
mortality rate – уровень смертности
clinical guideline – клиническое руководство
treatment protocol – протокол лечения
evidence-based medicine – доказательная медицина
patient outcome – исход лечения
quality of life – качество жизни
health economics – экономика здравоохранения
medical innovation – медицинские инновации
telemedicine – телемедицина