Polysemy – многозначность, наличие нескольких интерпретаций  
Intertextuality – перекличка с другими текстами, аллюзии, цитаты  
Diegesis – повествование в рамках мира рассказа  
Mimesis – подражание реальности в литературе  
Aporia – неустранимая логическая или смысловая неопределённость  
Metalepsis – нарушение границы между автором, рассказчиком и персонажем  
Focalization – точка зрения, через которую ведётся рассказ  
Unreliable narrator – ненадёжный рассказчик  
Ekphrasis – словесное описание произведения искусства  
Analepsis – ретроспекция, флэшбэк  
Prolepsis – предвосхищение событий (флэшфорвард)  
Catharsis – эмоционическая разрядка через искусство  
Hermeneutics – искусство толкования текста  
Close reading – детальный, внимательный анализ текста  
Defamiliarization – остранение, приём художественного отчуждения  
Subtext – скрытый, имплицитный смысл  
Aesthetic distance – отстранённость между читателем и текстом  
Discourse – структура и стиль высказывания, особенно властный  
Semiotics – изучение знаков и символов в литературе  
Paratext – элементы вне основного текста (заголовок, эпиграф, предисловие)  
Narratology – теория повествования  
Allegoresis – интерпретация текста как аллегории  
Tropological – связанный с переносными значениями (метафоры, метонимии)  
Heteroglossia – сосуществование множества голосов и точек зрения  
Dialogism – взаимодействие разнородных речей и мировоззрений  
Mytheme – базовая единица мифа (по Леви-Строссу)  
Motif – повторяющийся элемент или тема  
Hubris – чрезмерная гордость, ведущая к падению героя  
Bathos – намеренно резкий переход от возвышенного к банальному  
Verisimilitude – правдоподобие, убедительность вымышленного  
Pastiche – стилизация под чужой стиль без иронии  
Bildungsroman – роман воспитания, становления личности  
Roman à clef – роман с реальными людьми под вымышленными именами  
Epistolary – жанр письма, дневника, документа  
Tragic irony – трагическая ирония, когда зритель знает больше героя  
Liminality – пограничное состояние героя или текста  
Anagnorisis – момент узнавания/озарения героя  
Denouement – развязка, логическое завершение  
Hamartia – роковая ошибка или слабость героя  
Negative capability – способность к неразрешимости и многозначности (по Китсу)  
Frame narrative – рассказ в рассказе  
Fabula – фактическая последовательность событий  
Syuzhet – способ организации сюжета  
Eucatastrophe – внезапный счастливый поворот (Т.Р.Р. Толкин)  
Narrative unreliability – сомнительная достоверность рассказчика  
Symbolic economy – взаимодействие знаков в культурном контексте  
Mimetic desire – желание, сконструированное через подражание (Ж.Ж. Рене Жирар)  
Ideologeme – идеологический элемент, встроенный в художественный текст  
Textuality – «текстовость», самоосознанность текста как структуры  
Poststructuralism – отказ от устойчивых смыслов и иерархий в тексте  
Deconstruction – разложение текста на противоречия и нестабильные значения  
