Ubiquitous – повсеместный, распространённый (в скрытом, почти незаметном смысле)  
Salient – выделяющийся, заметный, особенно значимый  
Nuanced – тонко дифференцированный, с множеством оттенков  
Tentative – предварительный, неуверенный, подлежащий уточнению  
Conducive – способствующий (условие, создающее благоприятную среду)  
Contentious – спорный, вызывающий полемику  
Impetus – стимул, движущая сила  
Repercussion – отложенное негативное последствие  
Caveat – предостережение, важное ограничение  
Refutation – логическое опровержение  
Delineate – точно очерчивать, подробно описывать  
Underscore – подчёркивать значимость чего-либо  
Substantiate – подтверждать (аргумент, утверждение)  
Premise – исходное положение, основа аргумента  
Conflate – объединять два (разных) понятия в одно  
Ostensibly – как будто, по видимости (часто в ироничном контексте)  
Heuristic – приближённый метод мышления или анализа  
Contingent – зависящий от обстоятельств, условный  
Provisional – временный, промежуточный  
Mitigating – смягчающий (фактор, условие)  
Albeit – хотя и, несмотря на то, что  
Purported – якобы таковой, приписываемый  
Disparate – несопоставимый, резко отличный  
Dichotomy – противопоставление двух сущностей  
Conundrum – сложная проблема, интеллектуальная головоломка  
Juxtaposition – сопоставление (особенно контрастное)  
Ameliorate – улучшать (в трудной ситуации)  
Undermine – подрывать (позицию, аргумент)  
Extrapolate – делать вывод за пределами имеющихся данных  
Commensurate – соразмерный, соответствующий  
Preclude – предотвращать, исключать возможность  
Advocate – выступать в защиту идеи  
Reiterate – повторить для акцента  
Solicit – настойчиво запрашивать (инфу, мнение, помощь)  
Alleviate – смягчать (страдание, давление, проблему)  
Enumerate – перечислять по пунктам  
Imply – подразумевать  
Infer – делать вывод  
Coalesce – объединяться в нечто единое  
Supersede – вытеснять, заменять  
Redundant – избыточный  
Viable – жизнеспособный, осуществимый  
Feasible – практически осуществимый  
Pertinent – релевантный, уместный  
Devoid – лишённый (чего-либо важного)  
Invoke – апеллировать к (авторитету, закону, чувству)  
Entail – влечь за собой  
Supplant – занять чьё-то место, вытеснить  
Intrinsic – внутренне присущий  
Discern – распознавать с усилием  
Offset – компенсировать  
