politics – политика
governance – управление
policy – политика
ideology – идеология
democracy – демократия
authoritarianism – авторитаризм
totalitarianism – тоталитаризм
liberalism – либерализм
conservatism – консерватизм
socialism – социализм
communism – коммунизм
populism – популизм
nationalism – национализм
globalism – глобализм
political spectrum – политический спектр
legislation – законодательство
regulation – регулирование
executive – исполнительная власть
legislature – законодательная власть
judiciary – судебная власть
constitution – конституция
amendment – поправка
civil liberties – гражданские свободы
human rights – права человека
political party – политическая партия
coalition – коалиция
campaign – предвыборная кампания
election – выборы
suffrage – избирательное право
voter – избиратель
referendum – референдум
political discourse – политический дискурс
diplomacy – дипломатия
bilateral relations – двусторонние отношения
multilateral – многосторонний
international relations – международные отношения
foreign policy – внешняя политика
statecraft – государственное управление
political strategy – политическая стратегия
power – власть
hegemony – гегемония
leadership – лидерство
political reform – политическая реформа
public policy – государственная политика
civic engagement – гражданское участие
lobbying – лоббизм
interest group – группа интересов
think tank – аналитический центр
political campaign – политическая кампания
electoral system – избирательная система
proportional representation – пропорциональное представительство
winner-takes-all – система «победитель забирает всё»
gerrymandering – манипуляция округами
political corruption – политическая коррупция
transparency – прозрачность
accountability – подотчетность
populist rhetoric – популистская риторика
political polarization – политическая поляризация
political dissent – политическое несогласие
civil disobedience – гражданское неповиновение
protest – протест
revolution – революция
coup d'état – государственный переворот
insurgency – мятеж
separatism – сепаратизм
federalism – федерализм
decentralization – децентрализация
political legitimacy – политическая легитимность
public opinion – общественное мнение
political narrative – политический нарратив
ideological – идеологический
authoritarian – авторитарный
democratic – демократический
pluralism – плюрализм
political accountability – политическая ответственность
electoral fraud – фальсификация выборов
political scandal – политический скандал
voter turnout – явка избирателей
campaign finance – финансирование кампании
political patronage – покровительство
interest representation – представительство интересов
populist movement – популистское движение
political agenda – политическая повестка
policy implementation – реализация политики
legislative process – законодательный процесс
executive order – указ
judicial review – судебный пересмотр
political compromise – политический компромисс
strategic alliance – стратегический альянс
geopolitics – геополитика
national security – национальная безопасность
defense policy – оборонная политика
intelligence – разведка
surveillance – наблюдение
cyber warfare – кибервойна
sanctions – санкции
diplomatic immunity – дипломатический иммунитет
state sovereignty – государственный суверенитет
legislative agenda – законодательная повестка
political resolution – политическое разрешение