make a decision – принимать решение
take responsibility – брать на себя ответственность
bear in mind – иметь в виду
come to an agreement – прийти к соглашению
set a precedent – установить прецедент
break new ground – прокладывать новые пути
reach a consensus – достичь консенсуса
meet expectations – оправдать ожидания
play a role – играть роль
have an impact – оказывать влияние
set the stage – подготовить почву
take into account – учитывать
in light of – с учетом
in the event of – в случае
at the expense of – за счет
in terms of – с точки зрения
on behalf of – от имени
as a result of – в результате
due to – из-за
in contrast to – в отличие от
with regard to – относительно
in the context of – в контексте
in pursuit of – в поисках
on the basis of – на основе
in the long run – в долгосрочной перспективе
for the sake of – ради
in order to – для того чтобы
at the forefront of – на переднем плане
in the midst of – посреди
in the wake of – в результате
as far as – насколько
for the most part – в основном
in the absence of – при отсутствии
on the verge of – на грани
in the light of – с учетом
with a view to – с целью
in accordance with – в соответствии с
in compliance with – согласно
by means of – с помощью
in relation to – в отношении
in conjunction with – в связи с
with reference to – ссылаясь на
in the face of – несмотря на
in spite of – несмотря на
regardless of – независимо от
as opposed to – в противовес
as well as – а также
in addition to – в дополнение к
coupled with – в сочетании с
together with – вместе с
in collaboration with – в сотрудничестве с
in contrast with – в противовес
in comparison with – по сравнению с
in proportion to – в пропорции
at the rate of – со скоростью
on the record – официально
off the record – неофициально
in the meantime – тем временем
all of a sudden – внезапно
at the drop of a hat – мгновенно
on a regular basis – регулярно
time and again – снова и снова
by and large – в целом
in general – в общем
in particular – в частности
as a whole – в целом
to a large extent – в значительной степени
to some extent – в некоторой степени
in no uncertain terms – недвусмысленно
without a doubt – без сомнения
in all likelihood – скорее всего
on the contrary – наоборот
in brief – вкратце
to put it differently – иными словами
in other words – другими словами
that is to say – то есть
in essence – по сути
as a matter of fact – на самом деле
on the whole – в целом
in summary – вкратце
to sum up – подводя итоги
in conclusion – в заключение
in the final analysis – в конечном итоге
as far as I’m concerned – что касается меня
in my opinion – по моему мнению
from my perspective – с моей точки зрения
it goes without saying – само собой разумеется
needless to say – говорить не нужно
in any case – в любом случае
at the end of the day – в конце концов
all things considered – с учетом всего
by the same token – аналогично
for all intents and purposes – фактически
in effect – по сути
in reality – в действительности
in fact – на самом деле
to put it mildly – мягко говоря
to put it bluntly – прямо говоря
come to think of it – если подумать
on second thought – пересмотрев мнение