Solace – утешение в трудный момент  
Audacity – смелость, дерзость, вызывающая уверенность  
Turmoil – хаос, смятение  
Reclusive – уединённый, избегающий общества  
Frivolous – легкомысленный, пустой  
Epiphany – внезапное озарение, инсайт  
Incessant – непрекращающийся, бесконечный  
Unyielding – непреклонный, стойкий  
Bellwether – лидер, зачинатель тренда  
Trepidation – сильная тревога, страх перед будущим  
Vexing – раздражающий, вызывающий беспокойство  
Fortitude – сила духа, стойкость  
Reproach – упрёк, выражение недовольства  
Eloquent – выразительный, умеющий красиво говорить  
Insolent – наглый, вызывающий  
Reverence – благоговение, глубокое уважение  
Callous – черствый, безразличный к чувствам других  
Dilapidated – полуразрушенный, в запущенном состоянии  
Feign – притворяться, симулировать  
Impeccable – безупречный, без единого изъяна  
Resilient – способный быстро восстанавливаться  
Deft – ловкий, искусный  
Discrepancy – несоответствие, расхождение  
Lucid – ясный, понятный (о мыслях, речи)  
Nefarious – злобный, преступный  
Redundant – избыточный, лишний  
Rebuke – упрек, резкое осуждение  
Zealous – чрезмерно рьяный, фанатично преданный  
Subtlety – тонкость, нюанс  
Perilous – опасный, рискованный  
Imposing – внушительный, производящий впечатление  
Futile – тщетный, бесполезный  
Fracture – трещина, перелом (букв. и переносно)  
Allude – упомянуть намёком  
Deride – высмеивать, презирать  
Astute – проницательный, умеющий точно судить  
Wary – настороженный, осторожный  
Dispel – рассеять (страх, сомнение)  
Arduous – трудный, изнурительный  
Impartial – беспристрастный  
Melancholy – лёгкая грусть, меланхолия  
Subvert – разрушать изнутри (систему, авторитет)  
Reiterate – повторять снова (для акцента)  
Devious – хитрый, обходной, неискренний  
Benevolent – доброжелательный, милосердный  
Contemptuous – презрительный  
Falter – дрогнуть, запнуться, ослабеть  
Provoke – провоцировать, вызывать реакцию  
Ominous – зловещий, предвещающий беду  
Yearn – тосковать, жаждать чего-то недостижимого  
