Facade – внешняя видимость, маска, скрывающая суть  
Twist – искажение, интерпретация под углом  
Spin – манипуляционная подача информации  
Blur – размывание границ правды  
Veil – завеса, скрывающая истину  
Pretense – притворство, ложный облик  
Smokescreen – дымовая завеса, отвлекающий манёвр  
Leak – утечка информации (часто правды)  
Omission – намеренное упущение  
Feign – симулировать, прикидываться  
Whitewash – прикрытие неудобной правды  
Ruse – уловка, хитрость  
Mislead – ввести в заблуждение  
Cover – прикрытие, маскировка  
Distort – искажать факты  
Invent – выдумывать (не обязательно творчески — иногда лживо)  
Conceal – скрывать намеренно  
Frame – преподносить (событие, человека) в определённом свете  
Expose – раскрыть, вывести на свет  
Withhold – утаивать информацию  
Fabricate – сфабриковать, искусственно создать  
Deflect – уводить разговор или вину  
Embed – внедрить идею или ложь глубоко  
Gaslight – заставлять усомниться в собственной реальности  
Obscure – затемнять, усложнять понимание  
Misdirect – намеренно сбивать с толку  
Implant – внедрять мысль (часто незаметно)  
Misattribute – приписывать не тому  
Contrive – продуманно инсценировать  
Distill – выделять нужную “правду”, отфильтровывать  
Echo – повторять как правду, усиливать иллюзию  
Plant – подбросить информацию  
Misfire – провалиться (о лжи, манипуляции)  
Disguise – замаскировать  
Warp – изогнуть реальность  
Slant – подать под определённым углом  
Muddle – запутать восприятие  
Slip – проскользнуть незаметно (о лжи или факте)  
Twinkle – мелькнуть (о намёке на правду)  
Unravel – распутывать обман  
Snare – ловушка (ментальная, манипулятивная)  
Mask – скрывать истинный мотив  
Thread – вести линию (в т.ч. ложного повествования)  
Shift – изменить фокус или версию  
Crack – трещина в лжи, уязвимость  
Probe – исследовать, докапываться до сути  
Reveal – вскрыть скрытое  
Shade – добавить неоднозначности  
Prompt – вызывать реакцию (в том числе ложную)  
Overlay – наложить другую реальность  
Seed – заронить идею (намеренно)  
