Bloom – расцвет, момент раскрытия  
Flicker – мимолётный импульс (жизни, желания, надежды)  
Sprout – росток, начало становления  
Drift – отдаление от корней или прошлого  
Reckoning – момент осознания или расплаты  
Rust – след времени, утрата остроты  
Rush – стремительность, юношеский напор  
Fade – угасание, медленное исчезновение  
Hollow – внутреннее опустошение (часто в зрелости)  
Flare – вспышка энергии или эмоции  
Grip – сила удержания, контроля  
Wane – ослабление, убывание  
Crave – глубокое желание, тяга к новому  
Stumble – неуверенный шаг, ошибка в начале пути  
Tremor – внутреннее волнение, дрожь перемен  
Blemish – несовершенство, но с эстетикой роста  
Crackle – искра, живость момента  
Linger – задержка в переходном возрасте  
Tarnish – утрата блеска (в контексте времени)  
Chime – звон, отголосок памяти  
Veil – то, что скрывает возраст или прошлое  
Tether – связь с прошлым или с кем-то старшим  
Fray – изнашивание, потеря прочности  
Pulse – пульс жизни, присутствия  
Wilt – вянуть, терять силу  
Echo – повтор, отголосок опыта  
Nest – ощущение защищённости (в юности или старости)  
Rift – разрыв между поколениями  
Drowse – сонливость, вялость восприятия  
Shed – сбрасывание старого "я"  
Murmur – мягкий, внутренний голос памяти  
Spill – переполнение эмоцией, часто юношеской  
Fumble – неумелая попытка, поиск  
Glint – проблеск живости в возрасте  
Frail – хрупкий, но с оттенком достоинства  
Churn – внутренний хаос, метание  
Stride – уверенное, взрослое движение  
Latch – привязанность, эмоциональное сцепление  
Rattle – нервозность, возрастной страх  
Ripple – волновое влияние прошлых поколений  
Shimmer – лёгкое сияние воспоминаний  
Hinge – точка перехода от одного этапа к другому  
Mottle – пестрота, смесь опыта и наивности  
Nestle – уютно устроиться, прислониться (к памяти, дому, человеку)  
Waver – колебание, неуверенность выбора  
Splinter – осколок прошлого опыта  
Glimpse – мимолётный взгляд в прошлое или будущее  
Warp – искривление восприятия времени  
Crumble – разрушение старой формы  
Latchkey – метафора ранней независимости  
Tinge – лёгкий оттенок чего-то прошедшего  