Outburst – внезапный всплеск эмоций  
Dazzling – ослепительный, впечатляющий  
Wander – бродить без цели  
Fierce – яростный, интенсивный  
Glance – быстрый взгляд  
Stumble – споткнуться / запнуться  
Aftermath – последствия (обычно плохие)  
Sincere – искренний  
Trigger – спровоцировать  
Grasp – уловить, понять (внезапно)  
Remote – отдалённый / холодный в поведении  
Glimpse – мимолётный взгляд / отблеск  
Cunning – хитрый, изворотливый  
Fade – постепенно исчезать  
Stunning – ошеломительно красивый  
Rush – прилив (энергии, эмоций)  
Mumble – бормотать  
Tedious – утомительно скучный  
Crave – страстно желать  
Vivid – яркий (цвет, описание, воспоминание)  
Emerge – появляться, выходить из  
Harsh – резкий, суровый  
Hesitate – колебаться  
Steady – устойчивый, надёжный  
Delight – восторг  
Flicker – мерцать  
Boldly – смело  
Subtle – тонкий, едва уловимый  
Unfold – разворачиваться (о сюжете, событии)  
Grief – глубокая печаль  
Witty – остроумный  
Scold – отчитывать  
Eerie – зловеще странный  
Leap – прыгнуть (быстро, решительно)  
Downside – минус, обратная сторона  
Quaint – старомодно-очаровательный  
Thrive – процветать  
Blunt – прямолинейный (грубовато)  
Yearning – томительное желание  
Bitter – горький (вкус/опыт)  
Glance – взглянуть мельком  
Grimy – грязный, чумазый  
Vanish – исчезнуть  
Haunting – западающий в душу  
Soak – промокнуть / впитывать  
Reckless – безрассудный  
Resist – противостоять  
Genuine – подлинный, настоящий  
Mend – починить / исправить  
Cleverness – смекалка  
Flick – резкое движение / щелчок  
