Rugged – грубый, неровный, дикого характера (о рельефе)  
Lush – густой, пышный (о растительности)  
Serene – умиротворённый, спокойный  
Barren – бесплодный, пустой (о земле)  
Winding – извилистый (о дороге, тропе)  
Majestic – величественный  
Expansive – обширный, раскидистый  
Remote – отдалённый, труднодоступный  
Tucked – спрятанный, уютно расположенный  
Craggy – скалистый, с выступами  
Rolling – плавно холмистый  
Desolate – пустынный, покинутый  
Overgrown – заросший  
Gritty – суровый, "пыльный", нереализованный  
Drenched – промокший, насыщенный влагой  
Verdant – покрытый зеленью  
Dusty – пыльный, выцветший  
Jagged – зубчатый, остро неровный  
Stark – резко выделяющийся, суровый  
Breezy – продуваемый ветром, лёгкий  
Sun-dappled – освещённый пятнами солнца  
Arid – сухой, засушливый  
Swampy – болотистый  
Cramped – тесный, замкнутый  
Windswept – открытый ветрам  
Secluded – уединённый  
Misty – затуманенный  
Hazey – лёгкий туман, неясность  
Vast – огромный, бескрайний  
Pebbled – усыпанный галькой  
Sheltered – защищённый (от ветра, взгляда)  
Blazing – палящий, яркий (о солнце, цветах)  
Cluttered – загромождённый (визуально насыщенный)  
Gnarled – корявый, искривлённый (например, о дереве)  
Murky – мрачный, мутный  
Torrential – проливной (о дожде, воде)  
Cavernous – пещерный, огромный и тёмный  
Steep – крутой (о склоне, дороге)  
Leafy – зелёный, обрамлённый листвой  
Fragrant – ароматный  
Dilapidated – полуразрушенный, запущенный (о строении)  
Snug – уютно компактный  
Glistening – блестящий (о воде, траве, поверхности)  
Parched – пересохший, обожжённый  
Fertile – плодородный  
Tranquil – безмятежный  
Shaded – затенённый  
Beckoning – манящий  
Rumbling – гулкий (о горах, земле, шуме)  
Timeless – вне времени, неизменный  
