call the shots – принимать решения
make a difference – иметь значение
take into account – учитывать
bear in mind – помнить, иметь в виду
bring something to the table – внести что-то ценное
face the music – встретить последствия
keep an eye on – следить за
set the stage – создать условия
lay the groundwork – заложить основу
push the envelope – выходить за рамки
raise the bar – поднять планку
step up one’s game – повысить эффективность
turn a blind eye – закрывать глаза на
add insult to injury – усугублять ситуацию
get the ball rolling – начать дело
miss the mark – не попасть в цель
be on the same page – понимать друг друга
pull out all the stops – использовать все средства
raise eyebrows – вызывать удивление
take a back seat – уступить лидирующую роль
hit the ground running – сразу начать активно работать
play hardball – действовать жестко
make ends meet – сводить концы с концами
run the show – руководить
get cold feet – запнуться от страха
bend over backwards – очень стараться
cut corners – экономить
go the extra mile – приложить дополнительные усилия
put all your eggs in one basket – рисковать всем
leave no stone unturned – тщательно проверять
take the bull by the horns – взять быка за рога
go down in flames – потерпеть неудачу с размахом
speak volumes – говорить о многом
strike a chord – находить отклик
stick to one’s guns – придерживаться своих убеждений
call it a day – закончить работу
get a taste of your own medicine – испытать то, что сам причиняешь
come to grips with – разобраться с
get out of hand – выйти из-под контроля
hit the nail on the head – попасть в точку
miss the boat – упустить возможность
blow off steam – выпустить пар
chip in – внести свой вклад
come up with – придумать
crack down on – строго пресекать
cut the mustard – соответствовать требованиям
draw a line under – закончить что-то
fall through – провалиться
get down to business – приступить к делу
in the long run – в долгосрочной перспективе
keep one’s chin up – не унывать
let the chips fall where they may – пусть будет как будет
make a mountain out of a molehill – преувеличивать проблему
be on the ball – быть внимательным
raise the stakes – повысить ставки
roll with the punches – адаптироваться к обстоятельствам
shoot for the stars – стремиться к высотам
take it with a grain of salt – воспринимать с осторожностью
stay under the radar – оставаться незамеченным
walk on air – быть на седьмом небе
wind down – расслабиться
work wonders – творить чудеса
in a nutshell – в двух словах
on the fritz – не работать должным образом
over the moon – на седьмом небе
out of the blue – внезапно
behind the scenes – за кулисами
by the book – по правилам
in hot water – оказаться в беде
in the loop – быть в курсе событий
on thin ice – находиться в опасном положении
out of line – не по правилам
over the top – чрезмерно
under one’s belt – иметь за плечами (опыт)
in the nick of time – в последний момент
jump the gun – начать слишком рано
keep tabs on – внимательно следить
let off steam – разрядить эмоции
make waves – создавать проблемы
nip it in the bud – пресечь на корню
off the cuff – импровизированно
be on a roll – быть в удаче
play it by ear – импровизировать
pull the plug – прекратить, отключить
show someone the ropes – показать основы
step into someone’s shoes – войти в роль другого
stick your neck out – рисковать
take the plunge – решиться на что-то
throw in the towel – сдаться
under the weather – нездоровится
up in the air – в неопределённом состоянии
water down – разбавлять, смягчать
wind up – закончить, подвести итог
work out – получаться, тренироваться
zero in on – сосредоточиться на
bring about – привести к
come across as – восприниматься как
cutting-edge – передовой, инновационный
state-of-the-art – самое современное
trailblazing – новаторский